%%%%%%%
%..P. %
%     %
%     %
%   . %
%G    %
%%%%%%%