%%%%%%%
%..P. %
%   . %
%     %
%     %
% G   %
%%%%%%%