%%%%%%
%G P %
%%  .%
%%%%%%