%%%%%%
%G P %
%   .%
%%%%%%