%%%%%%
%P G.%
%    %
%%%%%%